1 5 2 4 1 5 0 0 4 0
1 5 0 2 4 1 0 2 5 0
1 0 5 5 1 2 1 4 4 3
2 1 2 2 0 0 2 4 4 0
2 0 4 2 0 0 1 5 1 2
0 3 4 1 3 0 4 2 1 3
1 0 3 5 2 5 1 0 4 3
2 4 0 1 0 2 4 2 4 0
0 4 5 5 2 5 3 1 4 3
3 0 3 3 5 5 3 4 1 1